6 6 
M34
T0
B15
RT-R4-R3

G B  P O Y  B
B CG G P B  O
R P  R Y CO B
B G  G Y G  R
Y CB Y B P  O
B P  G Y R  P

